8 8
4 4
0 0 1 1 1 0 0 0
0 0 1 3 1 0 0 0
0 0 1 0 1 1 1 1
1 1 1 2 0 2 3 1
1 3 0 2 5 1 1 1
1 1 1 1 2 1 0 0
0 0 0 1 3 1 0 0
0 0 0 1 1 1 0 0
9 9
1 3
1 1 1 1 1 0 0 0 0
1 0 0 5 1 0 0 0 0
1 0 2 2 1 0 1 1 1
1 0 2 0 1 0 1 3 1
1 1 1 0 1 1 1 3 1
0 1 1 0 0 0 0 3 1
0 1 0 0 0 1 0 0 1
0 1 0 0 0 1 1 1 1
0 1 1 1 1 1 0 0 0
8 10
1 8
0 0 0 1 1 1 1 1 1 1
0 0 1 1 0 0 1 0 5 1
0 0 1 0 0 0 1 0 0 1
0 0 1 2 0 2 0 2 0 1
0 0 1 0 2 1 1 0 0 1
1 1 1 0 2 0 1 0 1 1
1 3 3 3 3 3 0 0 1 0
1 1 1 1 1 1 1 1 1 0
